####################
#P.....#.....@..B..#
#.###.#.#.#####.@..#
#...#.#.#.....#.@..#
###.#V#.#####.#.@..#
#...#.#.....#.#....#
#.###.#####.#.#.####
#.....#..B..#.#....#
#.#####.######.###.#
#...@.....#....B...#
#.###.@.###.#.######
#...#.@...#.#......#
#..B.......H.......#
####################