####################
#P..@..#........@..#
#..@...#..@......@.#
#..B...#..H..#...B.#
#......#.....#.....#
####..###@@..##...##
#......#.....#.....#
#..V.........#..V..#
#...@.....@..#.....#
#..B...#.....#.....#
#......#.....#.....#
####@@@#@@@@@#@@@###
#........H.........#
####################