####################
#P.......#.....B...#
#.#####..#.#######.#
#.....#..#.....@...#
#..@..#..#####.@.###
#..@..#......#.@...#
#..@..######.#.###.#
#..@........#...#..#
#.#########.#.#.#..#
#.....B...#...#.#..#
#.#######.#####.#..#
#...@.....#.....#..#
###.@.#####.###.#..#
#...@.....H...V.#..#
####################