####################
#P..............B..#
#..##############..#
#..#.............V.#
#..#.@@@@@@@@@@.#..#
#..#.@........@.#..#
#..#B@.######.@.#..#
#..#.@.#..B.#.@.#..#
#..#.@.#.####.@.#..#
#..#..........@.#..#
#..#.@@@@@@V@@@.#..#
#..#....H.......#..#
#..##############..#
#............H.....#
####################