####################
#P.................#
#.@.@.@.@.@.@.@.@.@#
#............B.....#
#.@.@.@.@.@.@.@.@.@#
#.......H..........#
#.@V@.@.@.@.@.@.@.@#
#..................#
#.@.@.@.@.@V@.@.@.@#
#........H.........#
#.@.@.B.@.@.@.B.@.@#
#..................#
####################