######@####@@#######
#P..............B..#
@..###..@..........@
#..@....@..###.....#
#.......@..........#
@..B.........H.....#
@..........@.......#
#.....@............@
#..............B...@
#..V....@#.........@
#.......@..........#
@.............B....@
#..................#
@@@@@###@###@@###@##