####################
####################
####################
#####....BB....#####
#####....BB....#####
#..................#
#.BB............BB.#
#.BB.....PB.....BB.#
#.BB............BB.#
#..................#
#####....BB....#####
#####....BB....#####
####################
####################