####################
#P.......#.....B...#
#.#####..#.#######.#
#.....#..#.....@...#
#..@..#..#####.@.###
#..@..#......#.@...#
#..@..######.#.###.#
#..@........#...#..#
#.#########.#.#.#..#
#.....B...#...#.#..#
#.#######.#####.#.V#
#...@.....#.....#..#
###.@.#####.###.#..#
#...@.....H.....#..#
####################