####################
#P.....@.....B.....#
#..####@####..###..#
#..#.@@@..###..#...#
#..#..@....@...#...#
#..##.####.@.###...#
#.....#..#.@.....H.#
#.###.#..#.#####...#
#...#....#.....#...#
#...####.#..##.#.B.#
#..B..@..#..##.@...#
#.....@......H.....#
####################