@#####@@@@@@###@####
#.B...#.P.#.....@..#
#.....#...@........@
#..#.........#..#..#
@.....#...#.V...#..#
@.....@...#......B.@
@..#...H.....#..#..@
#.....#...#........#
#.B...@...#...V.#..#
@..#.........#.....#
#.....#...#.....#..@
@..#....H.....#....@
#...............B..#
####@@@#######@@@@##