####################
#P..@@@.....B...@@@#
#..@..@..####..@..@#
#..@..@..#..#..@..@#
#..@@@@@.#..#..@@@@#
#........#..#......#
#.######.#..#.###### 
#.#....#.#..#.#....#
#.#.B..#....#.#..B.#
#.#....######.#....#
#.####...........### 
#......@..@..@.....#
#..H...@..@..@...V.#
#......@..@..@.....#
####################